year,binary,budget_2013$,domgross_2013$,intgross_2013$,NET 
2013,FAIL,13000000,25682380,42195766,29195766
2012,PASS,45658735,13611086,41467257,-4191478
2013,FAIL,20000000,53107035,158607035,138607035
2013,FAIL,61000000,75612460,132493015,71493015
2013,FAIL,40000000,95020213,95020213,55020213
2013,FAIL,225000000,38362475,145803842,-79196158
2013,FAIL,92000000,67349198,304249198,212249198
2013,PASS,12000000,15323921,87324746,75324746
2013,PASS,13000000,18007317,18007317,5007317
2013,FAIL,130000000,60522097,244373198,114373198
2013,PASS,40000000,148430908,249484909,209484909
2013,PASS,25000000,37304874,50304874,25304874
2013,PASS,50000000,19452138,55940671,5940671
2013,PASS,18000000,33345833,68447831,50447831
2013,FAIL,55000000,107136417,218743570,163743570
2013,PASS,30000000,35266619,85001659,55001659
2013,FAIL,78000000,119640264,271725448,193725448
2013,PASS,76000000,368065385,970766005,894766005
2013,FAIL,5500000,24477704,26377704,20877704
2013,PASS,120000000,93050117,286192091,166192091
2013,FAIL,110000000,61737191,89737191,-20262809
2013,PASS,100000000,107518682,268418682,168418682
2013,PASS,40000000,57012977,66454811,26454811
2013,FAIL,70000000,25213103,103813103,33813103
2013,PASS,17000000,54239856,97402049,80402049
2013,PASS,160000000,238679850,788128122,628128122
2013,PASS,150000000,393050114,1004550114,854550114
2013,PASS,140000000,122523060,371923060,231923060
2013,FAIL,60000000,46000903,104100903,44100903
2013,PASS,30000000,4167493,4967493,-25032507
2013,FAIL,110000000,271814796,708714796,598714796
2013,FAIL,80000000,133668525,247023808,167023808
2013,PASS,50000000,55703475,225703475,175703475
2013,FAIL,23000000,25000178,33029713,10029713
2013,FAIL,35000000,134506920,176269721,141269721
2013,FAIL,5000000,83586447,161911222,156911222
2013,FAIL,200000000,408992272,1212692272,1012692272
2013,FAIL,195000000,65187603,197387603,2387603
2013,PASS,28000000,28795985,60839197,32839197
2013,FAIL,28000000,63914167,112914167,84914167
2013,PASS,30000000,116632095,151513429,121513429
2013,PASS,2000000,8008161,9408161,7408161
2013,PASS,15000000,71628180,148041253,133041253
2013,PASS,225000000,291045518,687999518,462999518
2013,PASS,12000000,17482517,17482517,5482517
2013,FAIL,75000000,117723989,351723989,276723989
2013,FAIL,120000000,89107235,287537983,167537983
2013,FAIL,70000000,98927592,150562164,80562164
2013,PASS,200000000,234770996,489570996,289570996
2013,FAIL,190000000,101802906,411002906,221002906
2013,FAIL,26000000,49875291,81275291,55275291
2013,PASS,35000000,17616641,46346651,11346651
2013,FAIL,15000000,9177065,9177065,-5822935
2013,PASS,90000000,68559554,200859554,110859554
2013,PASS,46000000,61002302,113402302,67402302
2013,FAIL,130000000,33618855,79019947,-50980053
2013,PASS,84000000,53262560,137162560,53162560
2013,FAIL,38000000,42025135,92425135,54425135
2013,FAIL,30000000,19316646,62616646,32616646
2013,FAIL,38000000,26947624,43047624,5047624
2013,PASS,28000000,71399120,93943623,65943623
2013,PASS,35000000,82834332,100734332,65734332
2013,PASS,30000000,32172757,60288363,30288363
2013,FAIL,190000000,228778661,466978661,276978661
2013,PASS,20000000,34341945,39093317,19093317
2013,PASS,32500000,21819348,35770721,3270721
2013,PASS,19000000,21345525,62045525,43045525
2013,PASS,13000000,51872378,58938768,45938768
2013,PASS,20000000,137400141,318000141,298000141
2013,PASS,25000000,16973715,70373715,45373715
2013,FAIL,135000000,187168425,573068425,438068425
2013,FAIL,30000000,36918811,51078541,21078541
2013,FAIL,26000000,3254172,6154172,-19845828
2013,FAIL,190000000,144840419,351040419,161040419
2013,FAIL,103000000,112200072,362000072,259000072
2013,PASS,43000000,159581587,230781587,187781587
2013,FAIL,250000000,257397516,937397516,687397516
2013,FAIL,50000000,26623701,58188384,8188384
2013,PASS,130000000,424088260,857088260,727088260
2013,FAIL,32000000,22537881,24255957,-7744043
2013,FAIL,58000000,44672764,93672764,35672764
2013,PASS,4000000,15179303,18541236,14541236
2013,FAIL,275000000,89289910,259989910,-15010090
2013,PASS,60000000,31165421,75965567,15965567
2013,FAIL,3000000,64473115,91100541,88100541
2013,PASS,110000000,71017784,348545841,238545841
2013,PASS,1500000,3491669,3491669,1991669
2013,PASS,5000000,21502690,26161443,21161443
2013,FAIL,100000000,115702857,365702857,265702857
2013,PASS,115000000,132556852,416456852,301456852
2013,FAIL,20000000,26004851,46578821,26578821
2013,FAIL,32000000,101470202,126294264,94294264
2013,FAIL,170000000,204674790,631674790,461674790
2013,FAIL,16000000,2322593,22594052,6594052
2013,FAIL,135000000,83028130,283828130,148828130
2013,FAIL,30000000,66380662,116643610,86643610
2013,PASS,37000000,150394119,270000119,233000119
2013,FAIL,150000000,73103784,205440387,55440387
2013,FAIL,190000000,202359711,539559711,349559711
2012,FAIL,68488103,38068365,116804318,48316215
2012,FAIL,12175663,71037735,83704673,71529010
2012,FAIL,9841994,6837603,26295088,16453094
2012,FAIL,49717290,13003980,71771007,22053717
2012,PASS,45151416,138016721,224540219,179388803
2012,FAIL,212059460,66190353,308594933,96535473
2012,FAIL,1826349,12983057,21388640,19562291
2012,PASS,1217566,603728,603728,-613838
2012,PASS,187708135,240755653,562725176,375017041
2012,FAIL,55805121,9628746,13760036,-42045085
2012,FAIL,1014639,18384886,38951995,37937356
2012,FAIL,12175663,65520463,128935373,116759710
2012,PASS,103493134,27505098,127863295,24370161
2012,PASS,25365964,67501874,99847390,74481426
2012,FAIL,101463857,165188672,431600549,330136692
2012,FAIL,31453796,95145068,164140491,132686695
2012,FAIL,39570904,35804351,82338719,42767815
2012,PASS,88273555,167508980,355225246,266951691
2012,PASS,86244278,150484138,364480509,278236231
2012,FAIL,60878314,81242857,220552732,159674418
2012,FAIL,3500503,697244,697244,-2803259
2012,PASS,279025606,74128153,286917566,7891960
2012,FAIL,15219578,15164322,37783896,22564318
2012,PASS,65951507,150988132,448493475,382541968
2012,FAIL,121756628,126816653,616887080,495130452
2012,PASS,65951507,184875236,276997302,211045795
2012,FAIL,147122592,219559143,757855127,610732535
2012,FAIL,218147292,181641463,633967639,415820347
2012,FAIL,86244278,65885725,171080229,84835951
2012,PASS,16234217,46178703,64949517,48715300
2012,FAIL,8117109,22879428,22879428,14762319
2012,PASS,42614820,26801198,36727096,-5887724
2012,PASS,5073193,54689359,144884139,139810946
2012,FAIL,60878314,56822855,109742304,48863990
2012,PASS,25365964,78398378,121927729,96561765
2012,PASS,16234217,12613776,12613776,-3620441
2012,PASS,17248856,65952616,117019460,99770604
2012,PASS,35512350,20572249,31852752,-3659598
2012,FAIL,65951507,45462690,48869204,-17082303
2012,FAIL,58849037,50606496,51102777,-7746260
2012,FAIL,147122592,104926572,311393491,164270899
2012,PASS,71024700,39082470,50852278,-20172422
2012,FAIL,33483073,17393015,42102643,8619570
2012,PASS,760979,4069672,4477791,3716812
2012,FAIL,13697621,15243980,23836212,10138591
2012,PASS,20292771,17786836,48646439,28353668
2012,PASS,21307410,134026609,230644998,209337588
2012,FAIL,3043916,48790826,89012016,85968100
2012,FAIL,202927713,308815675,1124923772,921996059
2012,PASS,172488556,157407735,406779965,234291409
2012,PASS,10146386,24754613,25021315,14874929
2012,PASS,5073193,14331045,31118489,26045296
2012,PASS,33483073,35588120,167975738,134492665
2012,FAIL,60878,4989,4989,-55889
2012,FAIL,50731928,221866693,557487654,506755726
2012,FAIL,68488103,37471707,58908258,-9579845
2012,FAIL,223220484,265866416,768984693,545764209
2012,FAIL,60878314,23727745,49296637,-11581677
2012,FAIL,279025606,454699213,1095143990,816118384
2012,PASS,1014639,54041622,103248087,102233448
2012,FAIL,65951507,60523416,182005391,116053884
2012,PASS,101463857,86272883,316546185,215082328
2012,FAIL,25365964,52335195,85574308,60208344
2012,FAIL,253659641,307439106,1029557373,775897732
2012,PASS,81171085,413983383,694530947,613359862
2012,FAIL,40585543,19298306,172073169,131487626
2012,FAIL,15219578,15862951,22306925,7087347
2012,FAIL,38048946,16484994,25484413,-12564533
2012,FAIL,55805121,31505670,124857587,69052466
2012,FAIL,15219578,21716836,47699629,32480051
2012,FAIL,138193773,296603952,844848985,706655212
2012,PASS,8866236,126844056,200511006,191644770
2012,FAIL,55805121,34855879,68338951,12533830
2012,FAIL,15219578,55128651,130843627,115624049
2012,FAIL,6087831,11663106,12310182,6222351
2012,PASS,12175663,92887325,97562697,85387034
2012,FAIL,21814729,16928587,75452356,53637627
2012,FAIL,126829821,59739858,201523449,74693628
2012,PASS,71024700,63233330,162727662,91702962
2012,PASS,32975753,17541229,24513601,-8462152
2012,PASS,38048946,41754612,81832836,43783890
2012,PASS,19278133,5388293,5510995,-13767138
2012,FAIL,152195785,84894893,306390492,154194707
2012,PASS,167415363,192185407,480342759,312927396
2012,PASS,53268525,97121930,139736750,86468225
2011,FAIL,28999342,38376408,42428850,13429508
2011,FAIL,8285526,36265871,42810004,34524478
2011,FAIL,20713816,5905595,15336023,-5377793
2011,FAIL,20713816,36312387,37560098,16846282
2011,PASS,181246,1368348,1844766,1663520
2011,FAIL,5178454,18318189,27464261,22285807
2011,FAIL,88033717,48120751,152893489,64859772
2011,PASS,13463980,1060729,5599381,-7864599
2011,PASS,19678125,103872387,224136189,204458064
2011,FAIL,72498355,86534481,219571833,147073478
2011,FAIL,17606743,28860115,39385487,21778744
2011,FAIL,4660609,207716,1294370,-3366239
2011,PASS,33659951,175142277,299587165,265927214
2011,FAIL,144996710,182959443,383795703,238798993
2011,FAIL,207138157,198283907,580147769,373009612
2011,PASS,932122,470329,470329,-461793
2011,FAIL,41427631,37974487,74257040,32829409
2011,FAIL,20713816,39629760,81937729,61223913
2011,PASS,62141447,78358394,142460919,80319472
2011,FAIL,10356908,776396,1087104,-9269804
2011,FAIL,168817598,103818215,182188693,13371095
2011,FAIL,18642434,54579387,76325433,57682999
2011,FAIL,38320559,74866751,99497492,61176933
2011,PASS,51784539,22062637,41357557,-10426982
2011,FAIL,15535362,36312033,80840663,65305301
2011,PASS,129461348,217326947,652320815,522859467
2011,FAIL,41427631,44107629,163522777,122095146
2011,PASS,24856579,53651623,65676025,40819446
2011,FAIL,31070724,18951742,41966863,10896139
2011,FAIL,207138157,120762760,239452924,32314767
2011,FAIL,37284868,46668987,86680344,49395476
2011,PASS,31070724,41695999,67675862,36605138
2011,FAIL,129461348,394609809,1375512553,1246051205
2011,FAIL,23820888,19618465,22967676,-853212
2011,FAIL,7249836,396614,396614,-6853222
2011,PASS,1864243,871074,889847,-974396
2011,FAIL,3107072,728476,864753,-2242319
2011,FAIL,65248520,111942955,191524428,126275908
2011,PASS,36249178,121733603,222195609,185946431
2011,FAIL,186424342,76500789,191637196,5212854
2011,FAIL,51784539,57067015,151193038,99408499
2011,FAIL,77676809,86484341,219113265,141436456
2011,FAIL,36249178,38894261,176134406,139885228
2011,PASS,5696299,5779651,15695916,9999617
2011,PASS,103569079,322549,97066426,-6502653
2011,FAIL,46606085,8602417,170412210,123806125
2011,PASS,7249836,38626496,39520511,32270675
2011,FAIL,82855263,106705263,222647578,139792315
2011,FAIL,828553,30100,478703,-349850
2011,FAIL,72498355,26021717,59839216,-12659139
2011,PASS,155353618,171146932,688566122,533212504
2011,FAIL,5696299,633541,13961315,8265016
2011,PASS,258923,3516575,3864669,3605746
2011,FAIL,27963651,82077930,175797590,147833939
2011,PASS,14499671,48869,48869,-14450802
2011,FAIL,3521349,5544660,18510079,14988730
2011,FAIL,155353618,22156282,40961320,-114392298
2011,PASS,1035691,3087434,3657064,2621373
2011,PASS,9735493,3139021,18688080,8952587
2011,PASS,31070724,58844493,160342190,129271466
2011,FAIL,150175164,216871479,719508092,569332928
2011,FAIL,51784539,78303911,115142275,63357736
2011,FAIL,56962993,70659436,196392298,139429305
2011,PASS,26927960,56491379,148791377,121863417
2011,PASS,25892270,73184210,154554145,128661875
2011,PASS,1035691,5547001,5547001,4511310
2011,PASS,5178454,25700491,26784257,21605803
2011,PASS,5178454,107741677,214429259,209250805
2011,PASS,41427631,38748242,103755310,62327679
2011,FAIL,258922697,249667634,1080913060,821990363
2011,FAIL,62141447,30176535,87157549,25016102
2011,FAIL,134639802,154587729,574795417,440155615
2011,FAIL,139818256,127656741,254266825,114448569
2011,FAIL,113925987,88513562,303703179,189777192
2011,PASS,43499013,39006354,93523336,50024323
2011,PASS,4142763,1103455,1103455,-3039308
2011,PASS,8285526,169597,2918985,-5366541
2011,FAIL,93212171,148745713,504919774,411707603
2011,FAIL,96319243,183068895,500093845,403774602
2011,FAIL,6731990,4145138,11166495,4434505
2011,PASS,6214145,1396324,11753231,5539086
2011,PASS,18642434,45418587,48841781,30199347
2011,FAIL,33142105,56664949,145440503,112298398
2011,PASS,25892270,10692928,11655479,-14236791
2011,PASS,77676809,37691379,92961937,15285128
2011,PASS,51784539,131537058,269379017,217594478
2011,PASS,4919531,1790661,3240628,-1678903
2011,FAIL,51991677,64726164,132354553,80362876
2011,FAIL,134639802,80361144,387342089,252702287
2011,FAIL,16571053,46261299,132834295,116263242
2011,PASS,10356908,48039108,139537943,129181035
2011,FAIL,31070724,43574905,73293915,42223191
2011,PASS,36042039,22208829,65074228,29032189
2011,PASS,3107072,18642,18642,-3088430
2011,PASS,1035691,588958,588958,-446733
2011,FAIL,93212171,106174662,241492267,148280096
2011,FAIL,113925987,102305579,236120048,122194061
2011,FAIL,6214145,5551069,16513705,10299560
2011,PASS,25892270,175762513,220726425,194834155
2011,PASS,14499671,31028712,119717677,105218006
2011,FAIL,41427631,60079594,90255363,48827732
2011,FAIL,44016858,30160867,79072292,35055434
2011,FAIL,46606085,91789051,166717137,120111052
2011,FAIL,38320559,34227129,99475649,61155090
2011,PASS,16571053,38631377,41942847,25371794
2011,PASS,113925987,147704169,583162839,469236852
2011,FAIL,93212171,21105217,144870266,51658095
2011,FAIL,36249178,13780555,64529403,28280225
2011,PASS,132050575,291326492,735276926,603226351
2011,PASS,155353618,187491749,465363438,310009820
2011,FAIL,21749507,25011304,84359926,62610419
2011,FAIL,88033717,80832113,158947830,70914113
2011,PASS,201959703,364967639,1163903170,961943467
2011,FAIL,72498355,82734459,162412399,89914044
2011,FAIL,25892270,14144548,25079651,-812619
2011,FAIL,51784539,78323650,123169061,71384522
2011,FAIL,196781,501887,1633890,1437109
2011,PASS,20713816,14511151,31807187,11093371
2011,FAIL,31070724,27645535,51935343,20864619
2011,PASS,165710526,151633733,368093107,202382581
2011,PASS,12428289,16893744,23562334,11134045
2011,PASS,124283,1654502,3200899,3076616
2010,FAIL,19228173,19586277,64879307,45651134
2010,PASS,213646368,356993585,1094287202,880640834
2010,FAIL,4486574,1115276,8629906,4143332
2010,PASS,8545855,3424437,19768384,11222529
2010,PASS,32046955,8014473,9449125,-22597830
2010,FAIL,3418342,6186017,12353318,8934976
2010,FAIL,37388114,5449304,26813941,-10574173
2010,PASS,13887014,114252393,353869648,339982634
2010,FAIL,1068232,10402326,17696585,16628353
2010,PASS,58752751,42131764,95774887,37022136
2010,FAIL,13352898,2179053,2222851,-11130047
2010,FAIL,16023478,132001,7075508,-8947970
2010,FAIL,47002201,33335524,51785833,4783632
2010,FAIL,133528980,174351340,526867848,393338868
2010,PASS,13352898,7261515,10824983,-2527915
2010,FAIL,39524578,47937418,59724746,20200168
2010,PASS,16023478,21598495,21953741,5930263
2010,FAIL,7477623,7978555,10724926,3247303
2010,PASS,58752751,105446665,162658630,103905879
2010,FAIL,26705796,85474402,118960872,92255076
2010,PASS,73707997,268675247,580578700,506870703
2010,PASS,10682318,35977680,67676882,56994564
2010,PASS,16023478,68370710,82205045,66181567
2010,FAIL,73707997,78009058,92718787,19010790
2010,PASS,26705796,25687431,33703834,6998038
2010,FAIL,69435070,107399007,226186388,156751318
2010,FAIL,21364637,1267498,6506276,-14858361
2010,PASS,8545855,62386303,81400037,72854182
2010,PASS,64093910,86071723,219892171,155798261
2010,FAIL,64093910,46269276,86749716,22655806
2010,FAIL,5341159,2897185,2897185,-2443974
2010,PASS,53411592,12281992,27878177,-25533415
2010,FAIL,12818782,24825729,38091703,25272921
2010,PASS,22432869,40304065,40611902,18179033
2010,FAIL,160234776,419868647,1073092418,912857642
2010,FAIL,42729274,65326144,97696078,54966804
2010,PASS,34183419,19019119,42718768,8535349
2010,FAIL,106823184,37919386,104177195,-2645989
2010,PASS,80117388,173054825,290797736,210680348
2010,FAIL,10575495,489308,489308,-10086187
2010,PASS,133528980,316178791,1021656625,888127645
2010,FAIL,38456346,53699864,67522890,29066544
2010,PASS,176258254,232427199,528636950,352378696
2010,PASS,10682318,5346997,16164710,5482392
2010,FAIL,170917095,312539208,889393184,718476089
2010,PASS,1602348,57694294,106685260,105082912
2010,PASS,181599413,333751233,666108069,484508656
2010,FAIL,8545855,6797830,7080589,-1465266
2010,FAIL,29910492,51351297,104182018,74271526
2010,FAIL,124983125,81637519,280028482,155045357
2010,PASS,27774028,42908822,73552139,45778111
2010,FAIL,21364637,12962924,30199340,8834703
2010,FAIL,32046955,56650955,84535576,52488621
2010,FAIL,32046955,34575465,109728398,77681443
2010,PASS,13352898,28408179,47356808,34003910
2010,PASS,8545855,1170108,16711628,8165773
2010,FAIL,2136464,1044487,1997517,-138947
2010,FAIL,138870139,158542540,343850165,204980026
2010,FAIL,534116,253492,6024539,5490423
2010,PASS,42729274,33127720,64137680,21408406
2010,PASS,37388114,31189851,104472930,67084816
2010,PASS,16023478,2600773,12294827,-3728651
2010,PASS,3204696,90535754,189624005,186419309
2010,FAIL,101482025,94825128,241919399,140437374
2010,PASS,3204696,4308792,4882010,1677314
2010,FAIL,42729274,55548791,135915826,93186552
2010,FAIL,213646368,96952376,357921415,144275047
2010,PASS,5341159,2381151,6238038,896879
2010,PASS,16023478,27952425,29343924,13320446
2010,FAIL,64093910,96546967,209843135,145749225
2010,PASS,17091709,20369301,60361637,43269928
2010,PASS,34183419,14893296,19436733,-14746686
2010,FAIL,224328687,112684730,344460978,120132291
2010,PASS,138870139,126383971,315890541,177020402
2010,PASS,90799707,33768214,51371013,-39428694
2010,PASS,37388114,63772921,64495830,27107716
2010,PASS,101482025,101853441,314787390,213305365
2010,FAIL,176258254,255026238,807844640,631586386
2010,FAIL,85458547,136747492,317084404,231625857
2010,FAIL,10682318,22877632,84062765,73380447
2010,FAIL,7477623,1907483,15367204,7889581
2010,FAIL,2029641,499507,4894571,2864930
2010,FAIL,2670580,350077,553731,-2116849
2010,FAIL,34183419,61684749,75403567,41220148
2010,PASS,277740279,214524387,626605502,348865223
2010,FAIL,117505503,82491105,189334662,71829159
2010,PASS,37388114,40048019,80417752,43029638
2010,PASS,165575935,111509464,446720616,281144681
2010,FAIL,26705796,12325477,16992803,-9712993
2010,PASS,20296405,41793064,58705899,38409494
2010,PASS,21364637,33304850,49783934,28419297
2010,FAIL,87595011,110101079,286572606,198977595
2010,FAIL,11750550,100004670,138082199,126331649
2010,FAIL,48070433,16601978,70003894,21933461
2010,FAIL,17625825,42588953,89509349,71883524
2010,FAIL,42729274,188640789,383593100,340863826
2010,PASS,4272927,22231363,38750611,34477684
2010,FAIL,13887014,232102,3864090,-10022924
2010,PASS,16023478,148267855,460216888,444193410
2010,FAIL,160234776,140763246,341528548,181293772
2010,PASS,1922817,43834199,74953449,73030632
2010,FAIL,26705796,25201119,28536765,1830969
2010,PASS,32046955,22591662,71844911,39797956
2010,FAIL,106823184,127354577,182599780,75776596
2010,PASS,10148202,3817511,5638803,-4509399
2010,FAIL,42729274,103578637,240268986,197539712
2010,FAIL,170917095,67459899,229831139,58914044
2010,PASS,29910492,25965625,54462053,24551561
2010,FAIL,20296405,29652476,53260400,32963995
2010,PASS,21364637,296908,296908,-21067729
2010,FAIL,106823184,72245755,297749724,190926540
2010,FAIL,39524578,98476300,162976800,123452222
2010,PASS,72639765,321037586,747325041,674685276
2010,FAIL,160234776,66433214,152366563,-7868213
2010,PASS,53412,418399,453089,399677
2010,FAIL,213646368,443321427,1136341723,922695355
2010,FAIL,213646368,183802922,424689202,211042834
2010,PASS,37388114,182927231,269490247,232102133
2010,PASS,5341159,239111,5850485,509326
2010,FAIL,101482025,87128132,181077698,79595673
2010,PASS,55548056,118024294,232414484,176866428
2010,FAIL,74776229,56055056,146808831,72032602
2010,PASS,10682318,163287,334204,-10348114
2010,FAIL,8545855,116798,116798,-8429057
2010,PASS,2136464,6977159,17232238,15095774
2010,FAIL,85458547,107085981,216086548,130628001
2010,PASS,21364637,27455751,35079607,13714970
2010,PASS,16023478,3469420,36584608,20561130
2009,FAIL,8142987,35168338,66015966,57872979
2009,PASS,43429264,69668214,151432312,108003048
2009,FAIL,217146319,180353228,856000062,638853743
2009,FAIL,32571948,34471863,52723125,20151177
2009,FAIL,15200242,16845625,24771466,9571224
2009,FAIL,7600121,10019987,32963430,25363309
2009,FAIL,7600121,9962673,30555070,22954949
2009,FAIL,3474341,2472641,3071090,-403251
2009,FAIL,10640170,17419505,18613810,7973640
2009,FAIL,76001212,672527,42335163,-33666049
2009,FAIL,1085732,675172,675172,-410560
2009,PASS,16285974,36766024,43567433,27281459
2009,PASS,8142987,13652981,32194912,24051925
2009,FAIL,162859739,144810370,532959416,370099677
2009,FAIL,21714632,17359628,25689537,3974905
2009,FAIL,70572554,21227211,47873178,-22699376
2009,FAIL,461435929,825707158,3022588801,2561152872
2009,PASS,22800364,10262276,10974592,-11825772
2009,FAIL,45600727,65203101,142000928,96400201
2009,PASS,32571948,63749284,125022454,92450506
2009,PASS,9228719,4825683,18740466,9511747
2009,FAIL,18457437,29492371,42596761,24139324
2009,PASS,28229022,30991293,48905553,20676531
2009,FAIL,21714632,15594794,20760850,-953782
2009,PASS,29314753,14398811,31814980,2500227
2009,FAIL,14114511,3338902,10504640,-3609871
2009,FAIL,108573160,135575603,257131292,148558132
2009,PASS,24971827,6637983,55170185,30198358
2009,PASS,65143896,81740638,136842415,71698519
2009,FAIL,21714632,32682233,55808316,34093684
2009,FAIL,868585,50749,2382117,1513532
2009,FAIL,32571948,125560771,233645777,201073829
2009,PASS,32571948,45709979,99223368,66651420
2009,FAIL,17371706,366974,366974,-17004732
2009,FAIL,21714632,9998368,9998368,-11716264
2009,FAIL,43429264,22803533,50485349,7056085
2009,FAIL,92287186,168358172,394190344,301903158
2009,FAIL,21714632,18708557,20203912,-1510720
2009,PASS,3257195,406796,6430020,3172825
2009,FAIL,18457437,70574746,99562425,81104988
2009,FAIL,78715541,56300661,78042718,-672823
2009,FAIL,162859739,129676275,312028062,149168323
2009,FAIL,190003029,163078512,328400169,138397140
2009,FAIL,54286580,22295397,38068663,-16217917
2009,FAIL,7600121,9963686,10528267,2928146
2009,FAIL,7925841,1974599,6833747,-1092094
2009,PASS,271432899,327846641,1014525504,743092605
2009,PASS,43429264,102008450,193683923,150254659
2009,FAIL,14114511,2212134,16443063,2328552
2009,FAIL,43429264,77564677,99593620,56164356
2009,FAIL,97715844,213426283,963009937,865294093
2009,FAIL,76001212,131190089,344146212,268145000
2009,FAIL,53200848,40705558,135164207,81963359
2009,PASS,92287186,122400359,243871325,151584139
2009,PASS,17371706,17594056,35646920,18275214
2009,PASS,43429264,102194949,137503693,94074429
2009,FAIL,54286580,86812530,203964063,149677483
2009,FAIL,57543775,79646802,142404318,84860543
2009,PASS,4885792,305576,305576,-4580216
2009,FAIL,45600727,1367688,12764862,-32835865
2009,FAIL,190003029,215356519,414410048,224407019
2009,FAIL,5428658,5439692,11591350,6162692
2009,PASS,7600121,1205715,5440068,-2160053
2009,FAIL,15200242,55965069,111564348,96364106
2009,PASS,29857619,53418244,104960933,75103314
2009,FAIL,86858528,21363903,58096258,-28762270
2009,FAIL,54286580,41391219,66905911,12619331
2009,FAIL,2062890,1569280,8452669,6389779
2009,PASS,13028779,597665,597665,-12431114
2009,FAIL,4668646,216308,10630704,5962058
2009,FAIL,43429264,11216534,18493734,-24935530
2009,FAIL,7165829,899,899,-7164930
2009,FAIL,65143896,45811424,118340524,53196628
2009,PASS,10857316,51644478,74614567,63757251
2009,FAIL,111287489,105429554,228416195,117128706
2009,PASS,41257801,34538780,48218998,6961197
2009,FAIL,97715844,226949041,541170116,443454272
2009,PASS,32571948,18468479,24386618,-8185330
2009,PASS,152002424,279825625,418745446,266743022
2009,PASS,65143896,40191563,99285148,34141252
2009,FAIL,86858528,41885106,129927709,43069181
2009,FAIL,217146319,136066564,403488847,186342528
2009,FAIL,38000606,277903289,331914441,293913835
2009,FAIL,54286580,8704817,40685241,-13601339
2009,FAIL,8685853,11153924,11153924,2468071
2009,PASS,27143290,16342407,28600229,1456939
2009,PASS,9011572,535587,1469316,-7542256
2009,PASS,43429264,72176939,203449410,160020146
2009,PASS,10857316,28465896,53729463,42872147
2009,FAIL,97715844,111304636,253160295,155444451
2009,FAIL,1411451,755495,1092072,-319379
2009,PASS,10857316,109320,109320,-10747996
2009,FAIL,38000606,301097804,509809040,471808434
2009,FAIL,32571948,8348849,69869659,37297711
2009,FAIL,23886095,36173125,45352277,21466182
2009,FAIL,20086035,20033106,35480909,15394874
2009,PASS,19543169,7185227,17041802,-2501367
2009,PASS,103144502,47896216,103029901,-114601
2009,FAIL,26057558,35208316,73122088,47064530
2009,FAIL,7057255,1204793,1530512,-5526743
2009,PASS,114001818,113351355,294230416,180228598
2009,FAIL,43429264,178014415,341690283,298261019
2009,FAIL,27143290,8809919,29981685,2838395
2009,FAIL,8685853,749470,2823897,-5861956
2009,FAIL,65143896,34439578,41750888,-23393008
2009,FAIL,119430476,71063643,165426811,45996335
2009,FAIL,42343532,68851502,107125483,64781951
2009,FAIL,41257801,96538057,222824741,181566940
2009,PASS,17371706,46328612,84913778,67542072
2009,PASS,38000606,11944429,34611919,-3388687
2009,PASS,228003635,436585563,908235868,680232233
2009,FAIL,190003029,318123879,794258938,604255909
2009,FAIL,32571948,91009693,181146433,148574485
2009,FAIL,149830960,116726786,199848831,50017871
2009,FAIL,16285974,5761658,38116460,21830486
2009,FAIL,108573160,83854815,107621685,-951475
2009,PASS,16285974,14161591,20472719,4186745
2009,PASS,38000606,11156585,13305365,-24695241
2009,FAIL,162859739,195304827,406960171,244100432
2009,FAIL,19543169,16596046,21373265,1830096
2009,PASS,25623266,82070762,111001503,85378237
2008,PASS,37878971,87835235,170836899,132957928
2008,FAIL,21645126,21873909,30016892,8371766
2008,FAIL,140693320,53630131,232772564,92079244
2008,PASS,32467689,65470243,69688090,37220401
2008,FAIL,21645126,12094392,33435494,11790368
2008,PASS,86580505,119158557,236319281,149738776
2008,PASS,27056408,3326198,21702440,-5353968
2008,PASS,162338447,123435400,339778437,177439990
2008,FAIL,40043484,65319955,176857711,136814227
2008,PASS,59524097,38679626,123166807,63642710
2008,FAIL,62770866,317867,32595998,-30174868
2008,PASS,41125740,8519189,12789087,-28336653
2008,PASS,27056408,86632922,184810452,157754044
2008,FAIL,70346660,39303255,78481785,8135125
2008,PASS,54112816,31001030,45745616,-8367200
2008,PASS,7575794,34893728,60458935,52883141
2008,PASS,35714458,11914311,23399667,-12314791
2008,PASS,21645126,36197653,55137666,33492540
2008,FAIL,86580505,109784884,192713668,106133163
2008,PASS,15151588,2875321,13697884,-1453704
2008,FAIL,541128,36208310,36226687,35685559
2008,FAIL,27056408,15740274,62280329,35223921
2008,PASS,32467689,68368797,113824188,81356499
2008,PASS,86580505,130028810,176998734,90418229
2008,FAIL,31385433,20153811,30459656,-925777
2008,PASS,1082256,2718061,6526145,5443889
2008,PASS,36796715,16331680,222200929,185404214
2008,FAIL,21645126,14342754,28801384,7156258
2008,FAIL,27056408,160277075,297125986,270069578
2008,PASS,9740307,5288138,5301200,-4439107
2008,FAIL,162338447,246696294,675702695,513364248
2008,PASS,89286146,82236872,173580993,84294847
2008,PASS,11904819,98008500,296963426,285058607
2008,FAIL,32467689,21134953,33564393,1096704
2008,FAIL,16233845,8442492,37374405,21140560
2008,FAIL,200217418,343101064,851257517,651040099
2008,PASS,64935379,18726740,62826552,-2108827
2008,FAIL,201299674,344811326,630352749,429053075
2008,FAIL,48701534,110070196,260720275,212018741
2008,FAIL,89286146,87844867,241465674,152179528
2008,FAIL,140693320,233155446,683889160,543195840
2008,FAIL,4870153,2296640,13255131,8384978
2008,FAIL,43290252,49797572,115313044,72022792
2008,PASS,37878971,44034081,92816237,54937266
2008,FAIL,64935379,12774146,54814990,-10120389
2008,FAIL,21645126,34460447,62006112,40360986
2008,FAIL,48701534,8568101,9859851,-38841683
2008,PASS,10822563,34077322,36303849,25481286
2008,PASS,40043484,51955621,101820495,61777011
2008,FAIL,28138664,94525760,109902346,81763682
2008,FAIL,1623384,4183,34541,-1588843
2008,PASS,27056408,10934736,16023683,-11032725
2008,PASS,19480614,47477881,61807319,42326705
2008,FAIL,248918952,183300049,640362486,391443534
2008,PASS,12987076,34298662,44688323,31701247
2008,PASS,12987076,13849484,14423083,1436007
2008,PASS,48701534,24796094,86109680,37408146
2008,FAIL,19480614,6169538,30080599,10599985
2008,PASS,58441841,75705803,180322655,121880814
2008,PASS,62229738,165203458,449403966,387174228
2008,FAIL,15151588,152944384,416148834,400997246
2008,PASS,129870757,47560583,101076746,-28794011
2008,FAIL,70346660,108732985,139036162,68689502
2008,PASS,5411282,13054780,17816707,12405425
2008,FAIL,21645126,3337178,4744112,-16901014
2008,PASS,27056408,156928235,245608963,218552555
2008,PASS,21645126,32533339,71583685,49938559
2008,FAIL,21645126,3822265,5986778,-15658348
2008,PASS,243507670,153270751,453996009,210488339
2008,FAIL,173161010,137997773,356938225,183777215
2008,FAIL,200217418,577216380,1085385502,885168084
2008,PASS,86580505,85895413,252238208,165657703
2008,PASS,12987076,34003083,61600619,48613543
2008,FAIL,59524097,56358790,139692526,80168429
2008,PASS,27056408,52205219,76014858,48958450
2008,FAIL,16233845,18417633,53998338,37764493
2008,FAIL,148810243,145895632,285085699,136275456
2008,PASS,15151588,288927,288927,-14862661
2008,PASS,43290252,29020656,84107503,40817251
2008,FAIL,35173330,37007113,122315840,87142510
2008,PASS,11904819,40876996,43272961,31368142
2008,PASS,29220920,47716642,47911629,18690709
2008,FAIL,9740307,56924095,89883201,80142894
2008,PASS,64935379,55062111,97925059,32989680
2008,PASS,17316101,29114940,54225162,36909061
2008,FAIL,6493538,28396504,50470238,43976700
2008,PASS,16233845,2384904,6904335,-9329510
2008,FAIL,97403068,119547447,203641087,106238019
2008,PASS,40043484,208626391,430655689,390612205
2008,FAIL,97403068,89911432,220674342,123271274
2008,PASS,17316101,25126430,113100998,95784897
2008,FAIL,194806136,242217798,576399965,381593829
2008,FAIL,2164513,2471710,12040820,9876307
2008,FAIL,81169223,145572728,370582375,289413152
2008,FAIL,29762049,45927188,47194630,17432581
2008,PASS,324677,936904,1532525,1207848
2008,PASS,37878971,86880989,236511649,198632678
2008,FAIL,54112816,105726675,244580160,190467344
2007,PASS,25279728,80878983,147480104,122200376
2007,PASS,16853152,32177067,72168247,55315095
2007,FAIL,53930087,60229701,79964640,26034553
2007,FAIL,33706305,44457488,90193752,56487447
2007,FAIL,33706305,19022584,37026824,3320519
2007,PASS,50559457,27351175,32995262,-17564195
2007,PASS,33706305,57278425,146285687,112579382
2007,PASS,18538467,20969716,44228231,25689764
2007,PASS,168531522,92349898,219085603,50554081
2007,PASS,68536152,133246132,163581806,95045654
2007,PASS,28088587,92393631,155031909,126943322
2007,PASS,8988348,514844,514844,-8473504
2007,FAIL,13482522,4438327,5950184,-7532338
2007,PASS,84265761,74896639,134277795,50012034
2007,PASS,23594413,48019515,55028051,31433638
2007,PASS,3089745,1070310,6060896,2971151
2007,PASS,22470870,90119077,132098426,109627556
2007,PASS,56177174,19303898,62207616,6030442
2007,PASS,95501196,143484229,382436383,286935187
2007,FAIL,134825218,148219809,323822443,188997225
2007,PASS,21347326,22808178,38896737,17549411
2007,PASS,84265761,133557691,227935344,143669583
2007,PASS,16853152,65467925,87090800,70237648
2007,FAIL,56177174,31088139,90538854,34361680
2007,PASS,168531522,328080020,1059438513,890906991
2007,FAIL,19662011,44590850,112315914,92653903
2007,PASS,8426576,19712359,37758262,29331686
2007,FAIL,17976696,26536733,91841386,73864690
2007,FAIL,28088587,15660322,16105323,-11983264
2007,PASS,168531522,288068696,657733649,489202127
2007,FAIL,22470870,20621917,63362472,40891602
2007,PASS,7864804,161223170,260044254,252179450
2007,PASS,30897446,167140312,246229599,215332153
2007,PASS,14044294,6692364,11857251,-2187043
2007,FAIL,123589783,151149634,430914277,307324494
2007,FAIL,24156185,55091699,104475669,80319484
2007,FAIL,44941739,56820503,162937935,117996196
2007,FAIL,28088587,83449513,184318713,156230126
2007,PASS,31459218,48433689,102990511,71531293
2007,FAIL,505595,121251476,218173082,217667487
2007,PASS,8201867,4992356,25552185,17350318
2007,PASS,337063045,347647302,1079721346,742658301
2007,PASS,22470870,53764481,91525361,69054491
2007,FAIL,168531522,231950669,703955827,535424305
2007,PASS,50559457,56905993,164220396,113660939
2007,FAIL,202237827,157437618,284285677,82047850
2007,FAIL,67412609,52810568,107527136,40114527
2007,PASS,179766957,362589890,907071412,727304455
2007,PASS,12808396,16853,25219695,12411299
2007,PASS,78648044,43408033,152303819,73655775
2007,FAIL,44941739,4144258,35987783,-8953956
2007,FAIL,19662011,136469216,190848721,171186710
2007,PASS,18538467,13361645,15321020,-3217447
2007,FAIL,2247087,390519,2641047,393960
2007,FAIL,50559457,105013679,195845194,145285737
2007,PASS,230326414,78769081,418222056,187895642
2007,FAIL,22470870,17752075,83345293,60874423
2007,PASS,17976696,39745163,60418363,42441667
2007,PASS,14606065,28755697,61544892,46938827
2007,FAIL,35953391,39541053,87179297,51225906
2007,PASS,10111891,7441321,11956776,1844885
2007,FAIL,56177,282178,456495,400318
2007,PASS,81456903,205760152,592187212,510730309
2007,FAIL,4494174,10591674,21543741,17049567
2007,FAIL,28088587,45191743,86747344,58658757
2007,FAIL,39324022,60838866,107968055,68644033
2007,FAIL,169655066,358686980,795775055,626119989
2007,PASS,7345604,9824,16088238,8742634
2007,PASS,1685315,21456928,24961971,23276656
2007,FAIL,31459218,32091974,62140782,30681564
2006,FAIL,69347781,243427977,524918705,455570924
2006,FAIL,23115927,6358748,8558769,-14557158
2006,PASS,9246371,21784947,21913233,12666862
2006,PASS,13869556,21494740,26558990,12689434
2006,PASS,10402167,18765207,18765207,8363040
2006,FAIL,115579635,66317186,198077969,82498334
2006,FAIL,9246371,14645442,14645442,5399071
2006,FAIL,20804334,148526717,302324822,281520488
2006,PASS,4623185,8098328,8098328,3475143
2006,FAIL,80905744,282110219,533594150,452688406
2006,FAIL,117891227,193439856,689276488,571385261
2006,PASS,87840522,41091314,80270290,-7570232
2006,FAIL,5778982,27910249,29928737,24149755
2006,FAIL,13869556,32175530,50768266,36898710
2006,FAIL,2311593,13042765,93847250,91535657
2006,PASS,34673890,555145,8964615,-25709275
2006,PASS,18492742,43497951,100602327,82109585
2006,FAIL,115579635,86719588,288357452,172777817
2006,FAIL,9246371,344554,485204,-8761167
2006,PASS,28894909,62526330,130371575,101476666
2006,FAIL,172213656,74740347,205345335,33131679
2006,PASS,13869556,6414581,6414581,-7454975
2006,PASS,7512676,15451191,20247613,12734937
2006,FAIL,86684726,225762418,753462808,666778082
2006,PASS,17336945,14643840,14643840,-2693105
2006,FAIL,57789817,102443127,213399577,155609760
2006,FAIL,12713760,84117369,98564824,85851064
2006,FAIL,86684726,48873044,84124832,-2559894
2006,PASS,52010836,44382535,50095967,-1914869
2006,FAIL,15025353,15899229,79468028,64442675
2006,PASS,16181149,6314137,17063043,881894
2006,PASS,9246371,69221912,116216452,106970081
2006,FAIL,31206501,26000177,64141457,32934956
2006,FAIL,23115927,43275535,47783141,24667214
2006,PASS,46231854,18449366,70344622,24112768
2006,PASS,34673890,3473867,41482984,6809094
2006,PASS,86684726,85137126,163276310,76591584
2006,FAIL,36985483,92692547,114766488,77781005
2006,PASS,127137598,289946849,663982857,536845259
2006,PASS,31784400,20238130,57503632,25719232
2006,FAIL,173369,10917487,21956864,21783495
2006,FAIL,98242689,98364347,219487695,121245006
2006,FAIL,15025353,5614135,5614135,-9411218
2006,PASS,73624227,2569674,154418394,80794167
2006,FAIL,260054178,489266869,1225855881,965801703
2006,FAIL,184927415,70127732,209979090,25051675
2006,PASS,462319,1956408,2915828,2453509
2006,PASS,6125721,2540087,33746588,27620867
2006,PASS,13869556,7928763,10063173,-3806383
2006,FAIL,28894909,39168966,63891969,34997060
2006,FAIL,2311593,230207,719837,-1591756
2006,PASS,2311593,2294593,2294593,-17000
2006,PASS,57789817,54302354,115559561,57769744
2006,PASS,17625894,9018043,14944843,-2681051
2006,FAIL,19648538,41218854,64779219,45130681
2006,PASS,38141279,39321133,71683430,33542151
2006,PASS,19648538,318283,421411,-19227127
2006,PASS,23115927,31103330,35135878,12019951
2006,PASS,34673890,46734845,52282667,17608777
2006,FAIL,268144752,231297965,451770741,183625989
2006,PASS,34673890,40154753,75578093,40904203
2006,FAIL,52010836,32527039,57340095,5329259
2006,FAIL,60101410,137316349,234562168,174460758
2006,FAIL,144474543,251427474,887444081,742969538
2006,PASS,3814128,22971,22971,-3791157
2006,FAIL,104021671,154080367,335803963,231782292
2006,PASS,40452872,144174568,377426561,336973689
2006,FAIL,40452872,11724410,17870505,-22582367
2006,PASS,23115927,45242306,81765471,58649544
2006,FAIL,4276446,3155666,15517247,11240801
2006,PASS,98242689,73138793,237158227,138915538
2006,PASS,57789817,30771576,67253922,9464105
2006,FAIL,19070640,46080031,96846559,77775919
2006,FAIL,46231854,60482951,132720223,86488369
2006,FAIL,22422449,9316281,17474248,-4948201
2006,FAIL,46231854,61361102,124705810,78473956
2006,FAIL,63568799,187916346,355205844,291637045
2006,FAIL,17336945,65235123,148965821,131628876
2006,FAIL,9593110,2114116,29669493,20076383
2006,FAIL,34673890,21407734,23950486,-10723404
2006,PASS,10864486,14909619,98936014,88071528
2006,FAIL,75126763,50329573,50329573,-24797190
2006,PASS,17336945,55316660,77374176,60037231
2006,FAIL,1155796,515676,531824,-623972
2006,PASS,242717233,270875277,530926095,288208862
2006,FAIL,62413003,87611686,150718167,88305164
2006,PASS,40452872,13857222,14454606,-25998266
2006,PASS,25427520,5083807,31481990,6054470
2005,PASS,65616822,30849435,57209924,-8406898
2005,PASS,35790994,23909452,42997982,7206988
2005,FAIL,178954969,244981925,445357804,266402835
2005,PASS,29825828,43368365,45754431,15928603
2005,PASS,95442650,75534696,156477397,61034747
2005,FAIL,29825828,2869746,4301386,-25524442
2005,FAIL,23860663,55777141,80163307,56302644
2005,PASS,3459796,3731178,3731178,271382
2005,FAIL,536865,2476430,4876515,4339650
2005,FAIL,16583160,99073958,207704444,191121284
2005,FAIL,8351232,34300335,59561080,51209848
2005,PASS,178954969,246312517,566045396,387090427
2005,PASS,5368649,252526,28002720,22634071
2005,FAIL,104986915,73550386,129491710,24504795
2005,PASS,53686491,80249227,91469619,37783128
2005,FAIL,89477485,90642097,275453129,185975644
2005,FAIL,536865,452658,1084540,547675
2005,FAIL,35790994,63659187,136925192,101134198
2005,PASS,41756160,23019456,29962909,-11793251
2005,FAIL,51300425,29274195,58503506,7203081
2005,PASS,71581988,30390244,59023039,-12558949
2005,FAIL,9544265,27566,532615,-9011650
2005,PASS,59651656,12132195,27403019,-32248637
2005,FAIL,83512319,33658253,65154327,-18357992
2005,FAIL,104390399,184557548,394556433,290166034
2005,PASS,65616822,107023409,269275914,203659092
2005,PASS,167024638,131889812,240751838,73727200
2005,FAIL,8351232,37581997,67510048,59158816
2005,PASS,1133381,1222429,9862884,8729503
2005,FAIL,178954969,345995160,1070044630,891089661
2005,PASS,59651656,78752930,171928818,112277162
2005,PASS,29825828,60964573,146862958,117037130
2005,FAIL,65616822,212102508,437585770,371968948
2005,PASS,20878080,61305929,131046803,110168723
2005,FAIL,5726559,56462050,98116369,92389810
2005,FAIL,3340493,26488687,28112307,24771814
2005,PASS,29825828,29087739,30699527,873699
2005,FAIL,85898385,74740591,115661627,29763242
2005,PASS,1193033,3194955,4244757,3051724
2005,PASS,69195921,57645130,120123026,50927105
2005,FAIL,246957858,260176695,656785445,409827587
2005,FAIL,131233644,56547877,261099301,129865657
2005,FAIL,17895497,5053494,15635698,-2259799
2005,FAIL,50107391,28811311,74138215,24030824
2005,FAIL,89477485,230965870,663994001,574516516
2005,PASS,59651656,23502402,26365681,-33285975
2005,PASS,17895497,27547047,104974897,87079400
2005,PASS,2386066,4635094,10051933,7665867
2005,PASS,101407816,68015836,192687798,91279982
2005,PASS,4772133,1031925,1149158,-3622975
2005,PASS,71581988,57835867,120952557,49370569
2005,FAIL,131233644,222305354,570671028,439437384
2005,FAIL,89477485,56524824,155427270,65949785
2005,PASS,35790994,21861428,30093356,-5697638
2005,FAIL,77547153,2470676,31819291,-45727862
2005,PASS,33404928,45779857,144259786,110854858
2005,PASS,23860663,8989900,9883481,-13977182
2005,PASS,31018861,69066839,114001241,82982380
2005,PASS,47721325,34690477,37784099,-9937226
2005,FAIL,95442650,152946861,311023751,215581101
2005,FAIL,5965166,103823819,182444702,176479536
2005,PASS,46528292,30439664,45949095,-579197
2005,FAIL,8947748,12269777,14028182,5080434
2005,PASS,47721325,88408312,189398567,141677242
2005,PASS,357910,39742,39742,-318168
2005,PASS,71581988,76281887,97384257,25802269
2005,FAIL,119303313,20303541,71484662,-47818651
2005,FAIL,137198810,453675396,1012883787,875684977
2005,FAIL,164638572,38316342,91167710,-73470862
2005,PASS,2386066,2472734,2478937,92871
2005,FAIL,8947748,29579478,47741203,38793455
2005,FAIL,31018861,130576566,211596412,180577551
2005,FAIL,59651656,46740275,82827477,23175821
2005,PASS,22071113,77825570,130250195,108179082
2005,PASS,1789550,849790,1343663,-445887
2005,PASS,214745963,348020836,893351507,678605544
2005,PASS,30422345,40061811,96730885,66308540
2005,PASS,8351232,31048038,68038213,59686981
2005,PASS,8351232,20335227,24982624,16631392
2005,PASS,21474596,89563925,172497916,151023320
2005,PASS,21474596,35207734,44200119,22725523
2005,FAIL,53686491,60867491,124098247,70411756
2005,PASS,143163975,42733150,194486964,51322989
2005,FAIL,34001444,7517458,18435915,-15565529
2005,FAIL,95442650,54372886,168784763,73342113
2005,FAIL,35790994,15165948,31238857,-4552137
2005,PASS,59651656,90600996,193201845,133550189
2005,PASS,47721325,57155491,110065560,62344235
2005,FAIL,1789550,8795916,13351738,11562188
2005,PASS,17895497,37851356,56281383,38385886
2005,PASS,1193033,10755555,19748472,18555439
2005,FAIL,5666907,1495363,3652785,-2014122
2005,PASS,59651656,84122001,154177511,94525855
2005,PASS,1342162,19237114,22277835,20935673
2005,PASS,34597961,142590606,223941260,189343299
2005,FAIL,157480373,279504224,723976090,566495717
2005,PASS,3579099,6596452,9686481,6107382
2005,FAIL,11930331,66922430,109871622,97941291
2005,PASS,53686491,63660149,86327778,32641287
2005,FAIL,77547153,33459258,69846769,-7700384
2004,PASS,36995786,70464299,118928779,81932993
2004,PASS,14798315,1778681,23680825,8882510
2004,FAIL,92489466,148941129,242105970,149616504
2004,PASS,23430665,63433191,86407246,62976581
2004,FAIL,8015754,1268976,1274887,-6740867
2004,PASS,67825608,7606108,73506419,5680811
2004,FAIL,30829822,103757037,110205951,79376129
2004,FAIL,135651216,29601758,88795016,-46856200
2004,FAIL,86323501,99002076,212779439,126455938
2004,FAIL,18497893,1480098,13821985,-4675908
2004,FAIL,2466386,7143667,13927421,11461035
2004,PASS,61659644,49578078,325432881,263773237
2004,PASS,123319288,49577287,101301096,-22018192
2004,PASS,55493679,39466636,75811746,20318067
2004,PASS,43161751,41913460,142404808,99243057
2004,FAIL,73991573,123529118,268429281,194437708
2004,PASS,24663858,9924151,9924151,-14739707
2004,PASS,9006109,68238010,124765870,115759761
2004,PASS,4316175,119364,119364,-4196811
2004,PASS,34529401,72746991,127577349,93047948
2004,PASS,36995786,140986916,206919534,169923748
2004,PASS,43161751,28256983,28256983,-14904768
2004,FAIL,24663858,42380545,90014995,65351137
2004,PASS,12331929,86973,86973,-12244956
2004,PASS,30829822,63727222,141861709,111031887
2004,FAIL,92489466,25908371,41939879,-50549587
2004,PASS,3082982,33027761,44430462,41347480
2004,PASS,11098736,22475144,22475144,11376408
2004,PASS,160315074,307729658,982470644,822155570
2004,FAIL,73991573,73527840,123102194,49110621
2004,PASS,135651216,61692142,94317626,-41333590
2004,PASS,27130243,15766017,24706665,-2423578
2004,FAIL,129485252,178567590,429892298,300407046
2004,FAIL,32063015,56097638,78295110,46232095
2004,PASS,13565122,12596630,16032690,2467568
2004,FAIL,24663858,21093356,124558238,99894380
2004,FAIL,8015754,2885618,14613600,6597846
2004,PASS,123319288,146290116,248645124,125325836
2004,PASS,3946217,8052286,17808733,13862516
2004,PASS,22197472,106112827,161490339,139292867
2004,PASS,36995786,123926269,286120974,249125188
2004,FAIL,34529401,79390606,79509747,44980346
2004,PASS,2096428,1234321,6106125,4009697
2004,FAIL,493277,54927590,56878201,56384924
2004,FAIL,49327715,17287347,26163275,-23164440
2004,FAIL,8632,523811,697797,689165
2004,PASS,61659644,46226886,53446952,-8212692
2004,FAIL,49327715,92866817,153930950,104603235
2004,PASS,61659644,62572303,159007986,97348342
2004,PASS,6165964,10958349,12613378,6447414
2004,FAIL,1479831,68053804,127137678,125657847
2004,FAIL,49327715,59141502,113591309,64263594
2004,FAIL,92489466,199052129,453599307,361109841
2004,PASS,6165964,16700976,37405681,31239717
2004,PASS,86323501,544117065,1155511754,1069188253
2004,PASS,20964279,88176131,135496025,114531746
2004,PASS,86323501,46565462,61327735,-24995766
2004,PASS,92489466,51848757,67017030,-25472436
2004,FAIL,246638575,460627734,966459425,719820850
2004,FAIL,24663858,40417692,61998567,37334709
2004,FAIL,135651216,126536475,264654077,129002861
2004,FAIL,104821395,217149789,355883988,251062593
2004,FAIL,16031507,71432302,118444284,102412777
2004,FAIL,147983145,71170953,132214001,-15769144
2004,PASS,154149110,230287423,686049183,531900073
2004,PASS,12331929,136094379,230953737,218621808
2004,PASS,113453745,322407292,779510522,666056777
2004,FAIL,61659644,29604924,42923407,-18736237
2004,FAIL,36995786,99890827,126127005,89131219
2004,FAIL,67825608,63171287,195122925,127297317
2004,FAIL,209642789,240410531,393449767,183806978
2004,PASS,55493679,117337605,150537624,95043945
2004,PASS,123319288,73344915,118660249,-4659039
2004,FAIL,92489466,95047057,269667169,177177703
2004,PASS,88398934,140827568,317721828,229322894
2004,FAIL,36995786,20130602,32462531,-4533255
2004,FAIL,184978932,164382856,597064223,412085291
2004,PASS,209642789,148168797,370143515,160500726
2004,PASS,13565122,4629167,16467879,2902757
2004,PASS,24663858,85274051,137438109,112774251
2004,PASS,43161751,20794820,51382801,8221050
2003,FAIL,96222609,160945047,299075134,202852525
2003,FAIL,25321739,20572268,75544402,50222663
2003,FAIL,88626087,84109786,156276743,67650656
2003,PASS,25321739,2980024,10586685,-14735054
2003,PASS,102553043,307285628,612120077,509567034
2003,PASS,151930435,127639706,287654957,135724522
2003,PASS,101286957,121079205,204640944,103353987
2003,FAIL,31652174,43879701,71451544,39799370
2003,PASS,75965217,131861413,207999839,132034622
2003,FAIL,101286957,129829011,231418562,130131605
2003,FAIL,8862609,41198066,41198066,32335457
2003,FAIL,86093913,42648478,95824131,9730218
2003,PASS,32918261,59375255,114450037,81531776
2003,FAIL,119012174,481783272,1147664217,1028652043
2003,PASS,32918261,139551191,203615191,170696930
2003,PASS,15193043,14730114,54798208,39605165
2003,PASS,8102957,5145199,100507729,92404772
2003,FAIL,25321739,85313907,91644342,66322603
2003,FAIL,94956522,38245683,64706900,-30249622
2003,PASS,20890435,16466075,20457336,-433099
2003,FAIL,63304348,133961521,224198644,160894296
2003,FAIL,173453913,167347872,310481535,137027622
2003,FAIL,35450435,66002713,104051689,68601254
2003,PASS,15193043,5972708,29998216,14805173
2003,PASS,31652174,45102830,45102830,13450656
2003,PASS,69634783,88750338,228019903,158385120
2003,FAIL,113947826,83123367,198084062,84136236
2003,PASS,31652174,114756967,158690184,127038010
2003,PASS,2532174,9244066,18282439,15750265
2003,FAIL,5064348,56449060,142498954,137434606
2003,PASS,56973913,75297075,313948928,256975015
2003,FAIL,170921739,118918972,269565280,98643541
2003,PASS,82295652,80780273,178778023,96482371
2003,PASS,6330435,43641017,73437720,67107285
2003,PASS,37982609,114118990,198566990,160584381
2003,PASS,126608696,61301208,120601727,-6006969
2003,FAIL,158260870,386677167,803907108,645646238
2003,PASS,35450435,48583127,153093346,117642911
2003,PASS,88626087,147977201,262275924,173649837
2003,PASS,56973913,139269669,196496696,139522783
2003,FAIL,37982609,53265467,60648814,22666205
2003,FAIL,63304348,76560557,111816793,48512445
2003,FAIL,7596522,2795488,3713077,-3883445
2003,FAIL,75965217,33530353,102259164,26293947
2003,FAIL,101286957,157862359,337646706,236359749
2003,PASS,50643478,141498677,212515222,161871744
2003,PASS,9875478,12825598,28412666,18537188
2003,PASS,215234783,190366677,548289460,333054677
2003,PASS,107617391,39389560,93858357,-13759034
2003,FAIL,75965217,134364760,223164081,147198864
2003,FAIL,25321739,60647568,171812557,146490818
2003,FAIL,177252174,140675650,578361911,401109737
2003,FAIL,98754783,84150728,226965337,128210554
2003,FAIL,119012174,478385772,1445122625,1326110451
2003,PASS,160793043,356471453,935102616,774309573
2003,PASS,139269565,176314964,537149747,397880182
2003,PASS,82295652,34058165,48432173,-33863479
2003,FAIL,25321739,102883716,166061455,140739716
2003,PASS,2532174,5825321,12035418,9503244
2003,FAIL,101286957,24664310,33808553,-67478404
2003,PASS,949565,52158,290250,-659315
2003,FAIL,27853913,65799413,121175229,93321316
2003,PASS,12660870,19520239,36272829,23611959
2003,PASS,158260870,272145004,516198274,357937404
2002,FAIL,5828306,16946895,32825657,26997351
2002,PASS,10361434,58367141,107442412,97080978
2002,PASS,10361434,3984522,54885065,44523631
2002,FAIL,53102348,151178596,314630213,261527865
2002,FAIL,38855376,84193406,137060380,98205004
2002,FAIL,23960815,29139615,29139615,5178800
2002,PASS,11656613,238643,238643,-11417970
2002,FAIL,16189740,27299975,30265212,14075472
2002,FAIL,81596291,276025731,379148984,297552693
2002,PASS,7253004,42149599,99379590,92126586
2002,FAIL,69939678,105786208,199896148,129956470
2002,PASS,38855376,51960544,66855105,27999729
2002,PASS,1942769,27403645,39310844,37368075
2002,PASS,38855376,45676592,110092382,71237006
2002,FAIL,67349319,213195306,454746230,387396911
2002,PASS,38855376,221070926,398510478,359655102
2002,PASS,15542151,48165989,73825215,58283064
2002,FAIL,64758961,10822278,10845911,-53913050
2002,FAIL,183915449,208448913,559442481,375527032
2002,FAIL,25903584,73045727,73045727,47142143
2002,FAIL,25903584,1541287,6923858,-18979726
2002,PASS,17484919,20595744,37596351,20111432
2002,FAIL,15542151,33525714,72155308,56613157
2002,PASS,38855,99819,99819,60964
2002,FAIL,125632384,100674928,246602123,120969739
2002,FAIL,9066255,329860,329860,-8736395
2002,PASS,129517922,339321257,1138436153,1008918231
2002,PASS,54397527,53805898,82607955,28210428
2002,FAIL,90662545,43467687,78073173,-12589372
2002,FAIL,84186649,228453301,500089862,415903213
2002,FAIL,11656613,6187673,6187673,-5468940
2002,FAIL,59578244,87117875,147161499,87583255
2002,PASS,103614337,188800252,318355051,214740714
2002,PASS,71234857,121659935,212199853,140964996
2002,PASS,2266564,188500,644143,-1622421
2002,FAIL,181325090,246626476,572168477,390843387
2002,FAIL,132108280,170995666,464742312,332634032
2002,FAIL,64758961,163572654,221824742,157065781
2002,PASS,6475896,312705749,456217193,449741297
2002,PASS,62168602,123441416,254254517,192085915
2002,FAIL,14246971,60311590,126716628,112469657
2002,PASS,45331273,39254038,39254038,-6077235
2002,PASS,9066255,8029593,21845695,12779440
2002,PASS,3885538,7580935,7580935,3695397
2002,FAIL,101023979,120393928,267396769,166372790
2002,FAIL,77710753,55772984,106399210,28688457
2002,PASS,45331273,51962213,134423285,89092012
2002,PASS,108795054,198543415,357850459,249055405
2002,FAIL,91572563,295256424,528777236,437204673
2002,FAIL,41445735,105104690,151403896,109958161
2002,FAIL,60873423,19388882,19388882,-41484541
2002,FAIL,180029911,522872106,1064074398,884044487
2002,FAIL,103614337,94826948,137956416,34342079
2002,PASS,5828306,531336,1324514,-4503792
2002,PASS,49216810,111186338,155060534,105843724
2002,FAIL,77710753,56022212,87182173,9471420
2002,FAIL,148945610,402382056,850538512,701592902
2002,FAIL,129517922,5713168,9189290,-120328632
2002,PASS,12951792,39252065,49303870,36352078
2002,FAIL,77710753,157324072,276261727,198550974
2002,FAIL,15542151,2304492,2304492,-13237659
2002,PASS,10361434,18156206,21831701,11470267
2002,PASS,32379480,53977881,125671845,93292365
2002,PASS,19427688,10851194,10851194,-8576494
2002,FAIL,121746846,443662324,1200694576,1078947730
2002,PASS,32379480,14780124,21274227,-11105253
2002,FAIL,25903584,16821330,34125645,8222061
2002,PASS,62168602,167199897,321487424,259318822
2002,FAIL,5180717,8452031,15281897,10101180
2002,FAIL,84186649,180322432,223840454,139653805
2002,PASS,55692706,31641581,57808305,2115599
2002,FAIL,27198764,32763432,56895840,29697076
2002,FAIL,77710753,65517936,135255080,57544327
2002,FAIL,129517922,49372949,118897452,-10620470
2002,PASS,19427688,24818223,25054743,5627055
2002,PASS,77710753,120911349,257796757,180086004
2002,PASS,90662545,101179654,148502998,57840453
2002,PASS,5569271,26913392,51667906,46098635
2002,PASS,20722867,21186244,28050694,7327827
2002,FAIL,90662545,183824786,346071886,255409341
2001,FAIL,102635985,224626742,418002230,315366245
2001,FAIL,53949684,73797860,132403823,78454139
2001,PASS,36843687,97449838,138373157,101529470
2001,FAIL,46054609,17454678,17454678,-28599931
2001,FAIL,39475379,14428526,23507863,-15967516
2001,FAIL,118426136,103447452,310408061,191981925
2001,FAIL,118426136,110600487,244811851,126385715
2001,FAIL,125005366,142951853,210128869,85123503
2001,FAIL,39475379,69727697,109586673,70111294
2001,PASS,32896149,94083718,370446373,337550224
2001,PASS,65792298,72368206,137490616,71698318
2001,FAIL,5921307,1671811,10127447,4206140
2001,PASS,94740909,148625750,231722738,136981829
2001,PASS,105267677,50411551,129402834,24135157
2001,FAIL,46054609,41578506,90414888,44360279
2001,PASS,7237153,8181731,11528926,4291773
2001,PASS,23685227,54344576,54344576,30659349
2001,PASS,114478598,217235991,460678038,346199440
2001,PASS,164480745,417880504,1282627914,1118147169
2001,PASS,7895076,4036110,4794811,-3100265
2001,PASS,13158460,298423,298423,-12860037
2001,FAIL,52633838,8045394,8045394,-44588444
2001,PASS,18421843,17265945,22305955,3884112
2001,PASS,28948611,39553522,44426118,15477507
2001,PASS,13158460,49876055,77554691,64396231
2001,PASS,28948611,18754529,18754529,-10194082
2001,FAIL,63160606,61970361,93343188,30182582
2001,FAIL,32896149,48467177,48467177,15571028
2001,PASS,1973769,9244768,11621399,9647630
2001,FAIL,921092,1501334,1501334,580242
2001,FAIL,123689520,172565543,361389438,237699918
2001,PASS,23685227,126970485,186599109,162913882
2001,PASS,328961,5540210,6178924,5849963
2001,FAIL,98688447,7118091,7118091,-91570356
2001,PASS,1579015,18259960,35561527,33982512
2001,FAIL,151322285,380836644,736554932,585232647
2001,PASS,69739836,75511622,235816959,166077123
2001,PASS,19737689,9499853,15684329,-4053360
2001,PASS,8552999,8123355,8123355,-429644
2001,FAIL,111846906,241348715,593089313,481242407
2001,FAIL,92109217,17891440,17891440,-74217777
2001,FAIL,199350663,261247866,591130447,391779784
2001,PASS,17105997,119792347,173215693,156109696
2001,PASS,52633838,93209654,93209654,40575816
2001,FAIL,13158460,643280,56286669,43128209
2001,FAIL,65792298,352192764,647149877,581357579
2001,PASS,30264457,35972640,50903377,20638920
2001,PASS,46054609,148285394,260132301,214077692
2001,FAIL,3947538,24333100,30325173,26377635
2001,FAIL,50002146,190155939,271738388,221736242
2001,PASS,28948611,23621318,30082587,1133976
2001,PASS,11842614,597730,597730,-11244884
2001,FAIL,143427209,415208284,1167441808,1024014599
2001,FAIL,94740909,36575310,49089389,-45651520
2001,FAIL,64476452,57773198,57773198,-6703254
2001,PASS,22369381,127008987,276257960,253888579
2001,PASS,39475379,142433448,217555094,178079715
2001,PASS,36843687,68889320,93992029,57148342
2001,PASS,36843687,79478222,124648152,87804465
2001,FAIL,25001073,55091786,90093288,65092215
2001,FAIL,59213068,100347776,137512958,78299890
2001,FAIL,13158460,26822383,26822383,13663923
2001,FAIL,92109217,132393654,266756984,174647767
2001,PASS,36843687,59439723,79978408,43134721
2000,PASS,58175060,50105659,83966868,25791808
2000,PASS,81174503,43999763,64088881,-17085622
2000,FAIL,10823267,20388715,38793859,27970592
2000,PASS,67645419,26316961,75682603,8037184
2000,PASS,8117450,25192844,27998998,19881548
2000,PASS,6764542,29757576,147846184,141081642
2000,FAIL,12176175,22950688,38928095,26751920
2000,PASS,13529084,92476091,122375366,108846282
2000,FAIL,114997212,316082883,578003746,463006534
2000,PASS,13529084,1727642,2643423,-10885661
2000,PASS,24352351,23271276,23271276,-1081075
2000,PASS,121761754,169526922,351399133,229637379
2000,PASS,56822152,144482383,308184297,251362145
2000,PASS,33822710,96475572,206318992,172496282
2000,FAIL,60880877,82238253,156648214,95767337
2000,PASS,16911355,5624704,61635111,44723756
2000,FAIL,18940717,63220562,99006237,80065520
2000,PASS,60880877,37133914,37133914,-23746963
2000,PASS,67645419,169855868,348786874,281141455
2000,FAIL,31116893,72113147,151575620,120458727
2000,FAIL,139349563,253918993,619204256,479854693
2000,FAIL,139755436,137513677,314744675,174989239
2000,FAIL,27058168,36903356,64779503,37721335
2000,PASS,121761754,99045530,258676083,136914329
2000,FAIL,108232671,53362591,78834500,-29398171
2000,PASS,20293626,37125324,37488584,17194958
2000,FAIL,74409961,224887250,412095756,337685795
2000,FAIL,6764542,34559865,53741710,46977168
2000,PASS,60880877,144500988,288738993,227858116
2000,FAIL,121761754,82357777,143408288,21646534
2000,FAIL,35175618,61566286,102501499,67325881
2000,PASS,31116893,53081479,71950493,40833600
2000,FAIL,40587251,59185579,181217915,140630664
2000,FAIL,108232671,23650043,45273684,-62958987
2000,FAIL,40587251,156470282,184951617,144364366
2000,PASS,6088088,4918474,9998139,3910051
2000,FAIL,32469801,44189098,44189098,11719297
2000,FAIL,33822710,75726795,123164396,89341686
2000,PASS,40587251,103499437,139734889,99147638
2000,PASS,5411634,16476533,37593061,32181427
2000,PASS,54116335,120595650,218952089,164835754
2000,FAIL,5817506,9397377,13738212,7920706
2000,FAIL,74409961,77024193,96313324,21903363
2000,FAIL,13529084,40713217,113093815,99564731
2000,PASS,2435235,4127634,4127634,1692399
2000,FAIL,67645419,53816800,53816800,-13828619
2000,FAIL,47351793,82907528,116230018,68878225
2000,PASS,135290838,120810082,229042753,93751915
2000,FAIL,13529084,16246592,60295888,46766804
2000,FAIL,148819922,153325570,291281175,142461253
2000,FAIL,128526296,68731346,88886081,-39640215
2000,FAIL,12176175,8182195,17671601,5495426
2000,PASS,32469801,77470905,115711368,83241567
2000,FAIL,108232671,46765640,90042204,-18190467
2000,PASS,101468129,30781343,49722060,-51746069
2000,FAIL,99091212,128525137,335655410,236564198
2000,FAIL,304404,1396303,1396303,1091899
2000,FAIL,101468129,92638183,288845939,187377810
2000,PASS,121761754,210329023,390576517,268814763
2000,FAIL,87939045,247318583,503417209,415478164
2000,PASS,20293626,45689304,55282615,34988989
2000,PASS,20293626,173264011,288440067,268146441
2000,FAIL,101468129,212812106,400920487,299452358
1999,PASS,18180006,53390436,84486720,66306714
1999,FAIL,55938481,50964770,134810098,78871617
1999,PASS,20976930,181881240,498213351,477236421
1999,FAIL,16781544,142364760,328251410,311469866
1999,FAIL,41953861,149475534,247367876,205414015
1999,FAIL,104884652,54891212,54891212,-49993440
1999,FAIL,32164627,26086372,26086372,-6078255
1999,FAIL,48946171,288139235,433988407,385042236
1999,PASS,18180006,31967340,45285530,27105524
1999,PASS,13984620,7329780,7329780,-6654840
1999,FAIL,50344633,95386564,164246788,113902155
1999,PASS,2796924,16139101,29005501,26208577
1999,PASS,1678154,3084486,3676824,1998670
1999,PASS,29367703,24837027,24837027,-4530676
1999,PASS,15383082,53463308,106008618,90625536
1999,PASS,18180006,8777963,8777963,-9402043
1999,FAIL,13984620,42864850,61460819,47476199
1999,PASS,13984620,14783713,14783713,799093
1999,PASS,11886927,20898032,24057538,12170611
1999,PASS,90900032,77882040,120627912,29727880
1999,FAIL,90900032,51785192,141040144,50140112
1999,FAIL,37758475,6272780,6272780,-31485695
1999,FAIL,69923101,49209977,64486776,-5436325
1999,FAIL,62930791,99883369,126593993,63663202
1999,PASS,33563089,40375263,40375263,6812174
1999,PASS,9090003,23599429,39693164,30603161
1999,PASS,4195386,4302816,4302816,107430
1999,FAIL,51743095,31396836,67751013,16007918
1999,PASS,33563089,22801624,22801624,-10761465
1999,FAIL,95095418,41621042,46795352,-48300066
1999,PASS,58735405,162347007,508660113,449924708
1999,FAIL,13984620,15142285,17939209,3954589
1999,FAIL,69923101,114011185,226027993,156104892
1999,FAIL,41953861,119910654,228850846,186896985
1999,FAIL,16781544,2884196,2884196,-13897348
1999,PASS,97892342,141340236,289577211,191684869
1999,FAIL,29367703,72772612,72772612,43404909
1999,PASS,160823133,663632711,1408313741,1247490608
1999,FAIL,146838513,195805974,417860454,271021941
1999,FAIL,202776994,239265412,626779240,424002246
1999,FAIL,174807753,45728169,86283567,-88524186
1999,PASS,839077,196538593,347238122,346399045
1999,FAIL,9789234,42613,575990,-9213244
1999,FAIL,83907722,191311527,406534833,322627111
1999,PASS,111876962,127524221,251987342,140110380
1999,FAIL,69923101,32387409,43819293,-26103808
1999,PASS,90900032,239808171,643684004,552783972
1999,FAIL,111876962,217300705,582299294,470422332
1999,FAIL,55938481,410457404,940894052,884955571
1999,FAIL,55938481,113683964,180110910,124172429
1999,FAIL,27969241,14782268,14782268,-13186973
1999,PASS,27969241,8672922,8672922,-19296319
1999,FAIL,125861583,343814937,715115132,589253549
1999,FAIL,104884652,19593418,42830263,-62054389
1999,FAIL,244730855,159152923,309380824,64649969
1999,FAIL,41953861,16191424,16191424,-25762437
1998,FAIL,18578720,23948203,23948203,5369483
1998,PASS,64310954,232660690,518911253,454600299
1998,FAIL,14291323,9603575,9603575,-4687748
1998,FAIL,200078524,288081893,792596781,592518257
1998,PASS,75744013,32659228,32659228,-43084785
1998,FAIL,64310954,100242021,187556021,123245067
1998,FAIL,35728308,46309872,72445844,36717536
1998,FAIL,2143698,3402201,3402201,1258503
1998,FAIL,38586572,20629634,38953947,367375
1998,PASS,114330585,200742590,499431243,385100658
1998,FAIL,21436985,25020345,25020345,3583360
1998,PASS,35728308,42992157,117404137,81675829
1998,FAIL,121476247,159419475,358211780,236735533
1998,PASS,37157440,93902242,93902242,56744802
1998,FAIL,26438948,15263526,19596124,-6842824
1998,FAIL,1857872,2354896,2354896,497024
1998,FAIL,2858265,1646948,1646948,-1211317
1998,FAIL,178641539,194811162,537353750,358712211
1998,PASS,24295249,78661926,78661926,54366677
1998,PASS,4287397,3925045,8212442,3925045
1998,PASS,42873969,85905591,116515728,73641759
1998,PASS,8574794,6566863,31136839,22562045
1998,FAIL,1929329,5570142,40524745,38595416
1998,PASS,114330585,98778237,194429617,80099032
1998,FAIL,85747939,47137546,47137546,-38610393
1998,FAIL,128621908,172382303,433741657,305119749
1998,FAIL,68598351,53681880,110847172,42248821
1998,FAIL,97181,4603452,6686214,6589033
1998,PASS,85747939,66955646,97662611,11914672
1998,PASS,92893600,55761862,55761862,-37131738
1998,PASS,57165293,32544916,54553553,-2611740
1998,FAIL,17149588,32758425,32758425,15608837
1998,FAIL,2500982,10385968,20769827,18268845
1998,PASS,50019631,201774709,350566156,300546525
1998,FAIL,14291323,24445621,27268466,12977143
1998,FAIL,1429132,30312,30312,-1398820
1998,FAIL,92893600,309171460,693179313,600285713
1998,PASS,37157440,143367401,399442481,362285041
1998,FAIL,114330585,106240687,235521005,121190420
1998,PASS,8574794,17022681,84046055,75471261
1998,PASS,7145662,7864191,7864191,718529
1998,FAIL,57165293,78807819,102531416,45366123
1998,PASS,2858265,9602769,11085232,8226967
1998,FAIL,104326659,52975497,71697130,-32629529
1998,PASS,100039262,100307450,168351786,68312524
1998,PASS,71456616,130247778,228297140,156840524
1998,PASS,85747939,33420854,69434988,-16312951
1998,FAIL,21436985,25008106,66011004,44574019
1998,FAIL,21436985,57570196,57570196,36133211
1998,FAIL,50019631,81415051,81415051,31395420
1998,FAIL,92893600,134093691,333988221,241094621
1998,FAIL,71456616,63890455,70178637,-1277979
1998,FAIL,85747939,144932864,312408324,226660385
1998,FAIL,28582646,2720259,7593849,-20988797
1998,FAIL,74314880,52021118,52021118,-22293762
1998,FAIL,85747939,179525030,354996466,269248527
1998,PASS,31440911,252219917,514630544,483189633
1998,PASS,20007852,54473818,103714796,83706944
1998,FAIL,28582646,28966833,28966833,384187
1998,FAIL,12862191,1506002,6948401,-5913790
1998,FAIL,28582646,42581425,79426456,50843810
1998,PASS,92893600,165524241,358426384,265532784
1997,PASS,40634668,11849668,11849668,-28785000
1997,FAIL,4353714,35768573,40327947,35974233
1997,FAIL,123355241,251000935,457529453,334174212
1997,PASS,87074287,69361952,233213967,146139680
1997,PASS,76915621,84757254,202885136,125969515
1997,PASS,72561906,215476950,455851198,383289292
1997,FAIL,26122286,78198499,98225585,72103299
1997,FAIL,181404766,155754415,345855898,164451132
1997,FAIL,21768572,38328318,62565379,40796807
1997,PASS,46439620,5207916,5207916,-41231704
1997,PASS,362810,17424311,21993652,21630842
1997,PASS,4208591,123355241,123355241,119146650
1997,PASS,2902476,780691,783612,-2118864
1997,FAIL,116099050,146745677,325247966,209148916
1997,FAIL,116099050,110466780,207213175,91114125
1997,PASS,130611431,146459429,240760405,110148974
1997,PASS,7256191,21541344,21541344,14285153
1997,PASS,87074287,38709226,38709226,-48365061
1997,PASS,58049525,61055139,72665044,14615519
1997,FAIL,116099050,134956149,258311390,142212340
1997,PASS,72561906,69904916,69904916,-2656990
1997,FAIL,52244573,18188044,18188044,-34056529
1997,PASS,79818097,152762052,253187730,173369633
1997,FAIL,14512381,200899879,327883215,313370834
1997,PASS,21768572,40757090,45090566,23321994
1997,PASS,101586669,143835260,363825398,262238729
1997,PASS,24671048,104852087,181767707,157096659
1997,FAIL,36281,4184879,4184879,4148598
1997,PASS,17414858,57575205,108447385,91032527
1997,FAIL,39183429,87840357,87840357,48656928
1997,FAIL,50793334,93757206,160514159,109720825
1997,FAIL,65305716,263270001,439305185,373999469
1997,FAIL,130611431,363811668,853024040,722412609
1997,PASS,29024763,3445395,218193652,189168889
1997,PASS,43537144,52139221,74488288,30951144
1997,FAIL,50793334,63701899,85470471,34677137
1997,FAIL,66756954,184036082,433809062,367052108
1997,FAIL,1451238,844655,910343,-540895
1997,PASS,34829715,147102287,147102287,112272572
1997,PASS,29024763,51446556,51446556,22421793
1997,PASS,50793334,3224642,3224642,-47568692
1997,PASS,58049525,79789061,127636188,69586663
1997,PASS,145123812,79482791,175744937,30621125
1997,PASS,82720573,88536300,222050207,139329634
1997,FAIL,137867622,92256459,382981741,245114119
1997,FAIL,72561906,70044851,70044851,-2517055
1997,FAIL,108842859,332459322,1141669701,1032826842
1997,FAIL,72561906,59882642,91380645,18818739
1997,FAIL,116099050,25615375,25615375,-90483675
1997,PASS,290247625,955890356,3171930973,2881683348
1997,PASS,130611431,69001723,174293699,43682268
1996,FAIL,5049561,18767,18767,-5030794
1996,PASS,6683242,5646983,10412962,3729720
1996,FAIL,96535720,104920957,220318272,123782552
1996,FAIL,81684071,31524414,89420791,7736720
1996,FAIL,84654401,76285021,154998762,70344361
1996,PASS,8762473,33017679,56186252,47423779
1996,FAIL,74258246,37763082,37763082,-36495164
1996,PASS,29703299,39791578,39791578,10088279
1996,PASS,10396154,36487162,76047227,65651073
1996,PASS,4455495,438856,438856,-4016639
1996,FAIL,29703299,38211750,38211750,8508451
1996,FAIL,2970330,2342531,3593608,623278
1996,PASS,19307144,39460903,39460903,20153759
1996,PASS,111387369,454711839,1213975115,1102587746
1996,FAIL,89109896,89989691,192822510,103712614
1996,FAIL,37129123,37163912,47857099,10727976
1996,PASS,371291,315278,1103798,732507
1996,PASS,118813194,56096190,150552679,31739485
1996,FAIL,118813194,268787949,679757008,560943814
1996,FAIL,21534891,68820654,219124769,197589878
1996,PASS,22277474,153041290,257002834,234725360
1996,PASS,6683242,19926891,19926891,13243649
1996,PASS,13366484,53538871,53538871,40172387
1996,FAIL,118813194,134353268,371588265,252775071
1996,FAIL,26732969,40004796,40004796,13271827
1996,PASS,68317587,136676591,222774739,154457152
1996,FAIL,74258246,49173429,168283656,94025410
1996,PASS,3712912,38402527,51323462,47610550
1996,FAIL,69802752,89466773,152713266,82910514
1996,PASS,22277474,36786742,82678338,60400864
1996,PASS,51980772,116906798,344137032,292156260
1996,FAIL,81684071,27598768,27598768,-54085303
1996,PASS,44554948,156668864,269541399,224986451
1996,FAIL,66832422,30304554,54067193,-12765229
1996,FAIL,148516493,148722709,483421183,334904690
1996,FAIL,96535720,49675220,49675220,-46860500
1996,PASS,62376927,61288998,61288998,-1087929
1996,FAIL,111387369,199115335,499118651,387731282
1996,FAIL,4604011,24507872,35645124,31041113
1996,PASS,130694514,359244145,736493287,605798773
1996,PASS,1485165,1912120,2399710,914545
1996,PASS,445549,2454193,3751503,3305954
1995,PASS,99370665,263057839,510765217,411394552
1995,FAIL,76438973,46331600,127356911,50917938
1995,FAIL,152877946,281342983,514478842,361600896
1995,FAIL,3821949,8062791,8062791,4240842
1995,FAIL,110072121,115492633,319514907,209442786
1995,FAIL,79496532,64878801,168777252,89280720
1995,PASS,84082870,153379682,431574441,347491571
1995,PASS,20944279,86526587,86526587,65582308
1995,FAIL,76438973,123865278,232408620,155969647
1995,FAIL,30575589,49000312,49000312,18424723
1995,FAIL,137590151,152897054,557210677,419620526
1995,FAIL,6115118,6575280,6575280,460162
1995,PASS,30575589,26706076,33815484,3239895
1995,PASS,99370665,153578601,401699506,302328841
1995,FAIL,9325555,3223228,3223228,-6102327
1995,FAIL,30575589,107676871,186714768,156139179
1995,PASS,76438973,103687285,103687285,27248312
1995,PASS,84082870,216444248,530639350,446556480
1995,PASS,42805825,58663337,184857731,142051906
1995,PASS,88669209,81725980,133156691,44487482
1995,PASS,50449722,26206460,63437029,12987307
1995,FAIL,45863384,153070026,501631742,455768358
1995,PASS,25224861,65727998,206375709,181150848
1995,PASS,61151178,31111815,57712577,-3438601
1995,FAIL,53507281,91810008,173293953,119786672
1995,PASS,38219486,6213469,6213469,-32006017
1995,PASS,94784326,91761643,164837302,70052976
1995,PASS,33633148,109333135,268326198,234693050
1995,PASS,382195,3379226,3787024,3404829
1995,PASS,33633148,77389465,168963355,135330207
1995,FAIL,48920943,28362620,28362620,-20558323
1995,FAIL,9172677,35684110,52665468,43492791
1995,FAIL,45863384,293190647,557286202,511422818
1995,FAIL,44334604,87356689,258121354,213786750
1995,FAIL,267536405,134909008,403974193,136437788
1995,PASS,1223024,6418026,7697090,6474066
1994,FAIL,18859976,113501532,168509796,149649820
1994,FAIL,78583235,66932266,187312473,108729238
1994,FAIL,42435,4830398,6120440,6078005
1994,PASS,22003306,20469628,20469628,-1533678
1994,FAIL,25146635,199877046,387258182,362111547
1994,PASS,28289965,9160394,9160394,-19129571
1994,FAIL,86441558,518169206,1067789822,981348264
1994,PASS,47149941,104519746,252256228,205106287
1994,PASS,23574970,78588426,78588426,55013456
1994,FAIL,47149941,80220683,80220683,33070742
1994,FAIL,15716647,198418,198418,-15518229
1994,PASS,94299882,45793007,132261912,37962030
1994,PASS,12573318,169627825,334652619,322079301
1994,PASS,47149941,190561429,445095443,397945502
1994,FAIL,86441558,112477236,308935323,222493765
1994,PASS,55008264,52529749,156259619,101251355
1994,PASS,70724911,144774225,184851675,114126764
1994,FAIL,62866588,4426622,23477761,-39388827
1994,FAIL,124633011,664468621,1497608078,1372975067
1994,FAIL,28289965,188474233,552628944,524338979
1994,FAIL,34576623,227629474,298301960,263725337
1994,FAIL,62866588,50034889,50034889,-12831699
1994,FAIL,39291617,44386120,44386120,5094503
1994,FAIL,70724911,90154744,90154744,19429833
1994,FAIL,44006612,70494790,160394011,116387399
1994,FAIL,157166470,229906901,574129115,416962645
1993,FAIL,104809829,135525899,411177020,306367191
1993,FAIL,22574425,111027894,250021852,227447427
1993,PASS,11125966,12820482,12820482,1694516
1993,FAIL,40311473,17304904,17304904,-23006569
1993,FAIL,23541900,114334580,114334580,90792680
1993,PASS,45148849,63467174,63467174,18318325
1993,PASS,101584911,638063379,1669905770,1568320859
1993,PASS,40311473,353443011,711555544,671244071
1993,PASS,483738,4077367,5789647,5305909
1993,PASS,40311473,154904378,518188770,477877297
1993,FAIL,67723274,33611556,33611556,-34111718
1993,PASS,54823603,51622860,51622860,-3200743
1993,FAIL,70948192,296492106,570351412,499403220
1993,FAIL,38699014,1079180,1079180,-37619834
1993,FAIL,24186884,37013943,103124758,78937874
1993,PASS,40311473,91112095,91112095,50800622
1992,FAIL,54791459,234673774,392672121,337880662
1992,PASS,66413889,178543655,219896498,153482609
1992,FAIL,46489723,360876835,836898388,790408665
1992,FAIL,91319098,91198182,263165037,171845939
1992,FAIL,18263820,19098934,35702407,17438587
1992,FAIL,132827779,270360376,443020974,310193195
1992,PASS,11622431,23629512,23629512,12007081
1992,PASS,91319098,97001885,247429345,156110247
1992,FAIL,11622,3388636,3390310,3378688
1992,FAIL,20754340,17807603,17807603,-2946737
1992,FAIL,69734584,32355474,110889898,41155314
1992,FAIL,33206945,288212232,596056107,562849162
1992,FAIL,58112153,79978777,79978777,21866624
1992,FAIL,18263820,87880798,87880798,69616978
1992,FAIL,1992417,4702152,4702152,2709735
1992,FAIL,6641389,103849232,103849232,97207843
1992,FAIL,16603472,84266502,84266502,67663030
1992,FAIL,19924167,45296775,45296775,25372608
1992,PASS,13282778,36039665,47945352,34662574
1992,FAIL,33206945,202059814,304005134,270798189
1991,PASS,34216807,374591278,772310338,738093531
1991,FAIL,34216807,64220970,64220970,30004163
1991,FAIL,119758826,204710301,514714575,394955749
1991,PASS,111204624,29458817,29458817,-81745807
1991,FAIL,85542018,283133658,668083163,582541145
1991,PASS,39349,2100070,2100070,2060721
1991,FAIL,46192690,128123117,165780431,119587741
1991,PASS,42771009,134569251,134569251,91798242
1991,FAIL,171084037,350481895,884189932,713105895
1991,PASS,51325211,194184224,327629772,276304561
1991,FAIL,39349328,148724056,148724056,109374728
1991,PASS,34216807,223652543,471724395,437507588
1991,FAIL,23951765,59415931,59415931,35464166
1990,FAIL,71319016,156307443,434511105,363192089
1990,PASS,23178680,47970190,60918157,37739477
1990,FAIL,12480828,7796169,7796169,-4684659
1990,FAIL,124808278,209185588,427582507,302774229
1990,PASS,35659508,96239640,96239640,60580132
1990,PASS,46357360,109310929,109310929,62953569
1990,FAIL,39225459,388031265,922868068,883642609
1990,FAIL,44574385,83343062,83343062,38768677
1990,FAIL,26744631,509505267,849917050,823172419
1990,PASS,12480828,8946919,8946919,-3533909
1990,FAIL,62404139,50489429,97650742,35246603
1990,PASS,24961656,318093987,771396947,746435291
1990,FAIL,53489262,215222722,357486568,303997306
1990,FAIL,222871925,104977970,354127435,131255510
1990,PASS,17829754,29717001,29717001,11887247
1989,PASS,75183554,222637302,624023495,548839941
1989,FAIL,65785609,472131898,773166847,707381238
1989,FAIL,18795888,76095227,76095227,57299339
1989,FAIL,30825257,180177604,450161527,419336270
1989,PASS,16916300,19098688,19098688,2182388
1989,FAIL,90220264,370601926,891248035,801027771
1989,FAIL,78942731,65159735,293529779,214587048
1989,FAIL,20675477,93590469,93590469,72914992
1989,FAIL,18795888,56481697,56481697,37685809
1989,FAIL,2255507,46504161,69059227,66803720
1989,FAIL,56387665,98133425,131947137,75559472
1989,PASS,131571219,101954772,101954772,-29616447
1989,PASS,33832599,13515193,13515193,-20317406
1989,FAIL,9397944,11572924,11572924,2174980
1988,FAIL,13787529,39899139,39899139,26111610
1988,FAIL,15757176,38576,38576,-15718600
1988,PASS,29544705,144427648,144427648,114882943
1988,FAIL,2954471,23253887,23253887,20299416
1988,PASS,17726823,65480292,87051866,69325043
1988,PASS,27575058,68346751,68346751,40771693
1988,PASS,55150116,160231261,273996307,218846191
1988,FAIL,59089410,75661244,160749995,101660585
1988,PASS,31514352,27287490,27287490,-4226862
1988,PASS,11817882,25198114,25198114,13380232
1988,PASS,18711647,27799598,27799598,9087951
1988,FAIL,49241175,340405101,813070285,763829110
1988,PASS,63028704,118825964,118825964,55797260
1988,PASS,24226658,94725930,161457571,137230913
1988,FAIL,13787529,16493007,16493007,2705478
1988,FAIL,7878588,25605411,25605411,17726823
1988,FAIL,29544705,220475172,426625542,397080837
1988,FAIL,137875291,303547209,692330924,554455633
1988,FAIL,25605411,88095701,88095701,62490290
1987,FAIL,41007948,315074388,567273267,526265319
1987,FAIL,7176391,12144594,12144594,4968203
1987,FAIL,28705563,321185920,656332204,627626641
1987,FAIL,26655166,254090104,254090104,227434938
1987,PASS,2050397,29861988,29861988,27811591
1987,FAIL,30755961,133670224,246442080,215686119
1987,FAIL,36907153,122481612,201487544,164580391
1987,FAIL,32806358,30331075,30331075,-2475283
1987,FAIL,246047687,112289613,454321579,208273892
1987,FAIL,46544021,78160088,78160088,31616067
1987,PASS,34856756,23021501,23021501,-11835255
1987,FAIL,51259935,90184679,90184679,38924744
1987,FAIL,17428378,66069067,66069067,48640689
1987,FAIL,30755961,63269112,63269112,32513151
1986,PASS,36104000,180860331,389321020,353217020
1986,FAIL,10618824,371241520,696594829,685976005
1986,PASS,33980236,12530212,27396565,-6583671
1986,FAIL,63712942,34608390,34608390,-29104552
1986,FAIL,63712942,82290329,82290329,18577387
1986,PASS,38227765,87887418,87887418,49659653
1986,FAIL,12742588,293001649,293001649,280259061
1986,FAIL,16990118,111046165,111046165,94056047
1986,PASS,31856471,4149267,4149267,-27707204
1986,FAIL,31856471,381854174,757760530,725904059
1985,FAIL,41136059,455981879,831110482,789974423
1985,PASS,32475836,21497131,21497131,-10978705
1985,FAIL,21650558,75937118,75937118,54286560
1985,FAIL,43301115,39837026,39837026,-3464089
1985,FAIL,54126394,33562937,33562937,-20563457
1985,PASS,38754498,14951574,14951574,-23802924
1985,PASS,58456506,22990322,22990322,-35466184
1985,PASS,32475836,202626921,202626921,170151085
1984,FAIL,78450540,141379105,263884353,185433813
1984,PASS,40345992,116494634,116494634,76148642
1984,FAIL,33621660,526202467,708968739,675347079
1984,FAIL,22414440,19729056,19729056,-2685384
1984,FAIL,40345992,59174122,59174122,18828130
1984,FAIL,100864980,61521969,61521969,-39343011
1984,PASS,5827754,73924796,73924796,68097042
1984,FAIL,67243320,534880544,653677077,586433757
1984,FAIL,24655884,332111304,332111304,307455420
1984,FAIL,62760432,403191555,746580777,683820345
1984,FAIL,10086498,182002774,182002774,171916276
1984,FAIL,3362166,5155321,5155321,1793155
1984,FAIL,17931552,140313263,140313263,122381711
1984,FAIL,40345992,171405568,195005629,154659637
1984,PASS,89657760,395820224,804883755,715225995
1984,FAIL,14345242,85217529,174875289,160530047
1983,PASS,16375486,211626424,471294841,454919355
1983,FAIL,76029041,723340482,1339748672,1263719631
1983,PASS,91234849,140245796,140245796,49010947
1983,FAIL,13923842,4960460,4960460,-8963382
1983,FAIL,28072261,174127177,174127177,146054916
1982,FAIL,67571504,78808471,79974780,12403276
1982,PASS,30165850,16892876,50678628,20512778
1982,FAIL,48265360,92341492,190923490,142658130
1982,FAIL,12066340,30390060,30390060,18323720
1982,FAIL,25339314,1050038377,1913637848,1888298534
1982,FAIL,10859706,65382380,65382380,54522674
1982,FAIL,33785752,113937390,302172295,268386543
1982,FAIL,5429853,88542965,88542965,83113112
1982,PASS,25821968,180285645,293709241,267887273
1982,FAIL,9653072,264234708,264234708,254581636
1982,FAIL,28959216,192851397,233604343,204645127
1982,PASS,49471994,168208730,168208730,118736736
1982,FAIL,36199020,427631090,427631090,391432070
1982,FAIL,41025556,64961738,64961738,23936182
1981,FAIL,30742635,29430119,217684336,186941701
1981,FAIL,15371317,64674049,64674049,49302732
1981,FAIL,3202358,55651281,55651281,52448923
1981,PASS,6404716,65414737,65414737,59010021
1981,FAIL,23825542,50138908,50138908,26313366
1981,FAIL,28180748,81140060,81140060,52959312
1981,FAIL,51237724,635757611,998945973,947708249
1981,FAIL,960707,6148527,75319455,74358748
1981,FAIL,30742635,95814545,95814545,65071910
1980,FAIL,9897188,235987236,235987236,226090048
1980,PASS,56555357,5655536,5655536,-50899821
1980,PASS,50899822,63498970,220444178,169544356
1980,FAIL,98971875,76655018,76655018,-22316857
1980,FAIL,48072054,183810620,259308493,211236439
1980,FAIL,124421786,9852879,9852879,-114568907
1980,PASS,42416518,197512086,197512086,155095568
1980,FAIL,50899822,66113787,66113787,15213965
1980,FAIL,14421616,27456486,27456486,13034870
1980,FAIL,65038661,820821721,1510514303,1445475642
1980,FAIL,152699465,305924063,305924063,153224598
1980,FAIL,76349732,161832844,161832844,85483112
1980,PASS,50899822,83450574,104764631,53864809
1980,FAIL,53727589,124470916,124470916,70743327
1979,PASS,28886103,259752278,653566146,624680043
1979,FAIL,101101360,252913878,252913878,151812518
1979,FAIL,99496576,225632559,674971936,575475360
1979,FAIL,112334844,264014024,446129810,333794966
1979,PASS,59376989,209370867,350406635,291029646
1978,FAIL,10712118,505611968,505611968,494899850
1978,FAIL,99979768,210638678,369399800,269420032
1978,PASS,10712118,12307327,13071926,2359808
1978,PASS,21424236,649203517,1383697739,1362273503
1978,FAIL,53560590,208062006,276781136,223220546
1978,FAIL,6248735,332258,4565044,-1683691
1978,FAIL,196388829,479253080,1071925937,875537108
1978,FAIL,53560590,178535299,178535299,124974709
1977,FAIL,99921804,195231833,195231833,95310029
1977,PASS,15372585,147005823,147005823,131633238
1977,FAIL,76862926,637962288,1297830510,1220967584
1977,FAIL,384315,26902024,26902024,26517709
1977,FAIL,13066697,119379800,119379800,106313103
1977,PASS,23058878,250220,5246310,-17812568
1977,FAIL,42274609,1771682790,3066446442,3024171833
1976,FAIL,122754817,82003880,147473116,24718299
1976,PASS,12275482,54012120,54012120,41736638
1976,FAIL,28642791,102295681,102295681,73652890
1976,PASS,15548943,96934884,96934884,81385941
1976,FAIL,4091827,479705967,920661128,916569301
1976,FAIL,18004040,147901939,147901939,129897899
1976,PASS,40918272,99830228,100905781,59987509
1976,FAIL,4091827,115645570,115645570,111553743
1975,FAIL,47609104,86562007,86562007,38952903
1975,FAIL,51937204,1125306085,2037236823,1985299619
1975,FAIL,1731240,14835412,21765791,20034551
1975,FAIL,19043641,471681892,471681892,452638251
1975,FAIL,5193720,605399166,605399166,600205446
1974,PASS,42513535,76693179,76693179,34179644
1974,FAIL,12281688,564485269,564485269,552203581
1974,FAIL,7557962,20878869,20878869,13320907
1974,PASS,61408439,270669505,270669505,209261066
1974,FAIL,661322,125520924,125520924,124859602
1974,FAIL,661322,125520924,125520924,124859602
1974,FAIL,13226433,407657562,407657562,394431129
1973,FAIL,4074506,603047833,734145189,730070683
1973,FAIL,82329139,82329139,82329139,0
1973,FAIL,10487788,96197818,96197818,85710030
1973,PASS,62926730,1074306128,2111900435,2048973705
1973,FAIL,28841418,837011132,837011132,808169714
1972,PASS,66866,2305762,2305762,2238896
1972,FAIL,39004975,752051643,1496119403,1457114428
1971,FAIL,14386286,70780525,70780525,56394239
1971,FAIL,305063707,404702718,616827003,311763296
1971,FAIL,143862856,59412143,64760273,-79102583
1971,FAIL,12659931,236848653,236848653,224188722
1971,FAIL,17263543,23018057,23018057,5754514
1970,PASS,5997631,53978683,53978683,47981052